22,22,0,0
20,20
..###################
....................#
#.###.#.###.###.#####
#.#.#.#.#.....#.#...#
#.#.###.#.###.#####.#
#.#.#...#.#...#.#...#
###.#.###.#.###.###.#
#.#.#.#...#.........#
#.#.#.#.#.###.###.###
#.....#.#.#.....#...#
#.#.#.###.###.#####.#
#.#.#...#...#.#.....#
###.#.###.#######.###
#...#...#...#.......#
###########.###.#####
#...#.......#.....#.#
#.###.#######.#####.#
#...#.......#...#.#.#
#.#.#.#########.#.#.#
#.#.....#...........#
###################..