22,22,0,0
..###################
......#.....#.......#
#.#.###.###.#.#.#####
#.#.....#.....#.#.#.#
#######.#######.#.#.#
#.....#.......#.#...#
###.###.###.#.###.###
#...#...#...#...#...#
#.#.#.#####.#####.#.#
#.#...#.#.......#.#.#
#####.#.###.#######.#
#.......#.#...#...#.#
#########.#.#.###.#.#
#...#.......#.......#
###.###.#.#####.#.#.#
#.#.....#...#...#.#.#
#.###.#######.###.#.#
#.#.#...#.......#.#.#
#.#.#.#####.#######.#
#.........#.#.......#
###################.#
